NO ./textures/north.xpm
SO ./textures/south.xpm
WE ./textures/west.xpm
EA ./textures/east.xpm

F 164,169,20
C 153,204,255

111111
100001
100001
111111
1

