NO./textures/north.xpm           
SO ./textures/south.xpm
WE ./textures/west.xpm
EA ./textures/east.xpm

F 20,20,20
C 200,200,200

1111111111111
1           1
1   00000   1
1  00N000   1
1   00000   1
1           1
1111101111111










