NO       ./textures/north.xpm  
SO ./textures/south.xpm
WE ./textures/west.xpm
EA ./textures/east.xpm
C0,0,0
F255,255,55




        1111111111111111111111111
        1000000000110000000000001
      111011000001110000000000001
      111001000000000000000000001
111111111011000001110000000000001
1000000000110000011101111111111111111111111111
11110111111111011100000010001
11110111111111011101010010001
11000000110101011100000010001
10000000000000001100000010001
10000000000000001101010010001
11000001110101011111011110N0111
11110111 1110101 101111010001
11111111 1111111 111111111111





111   111
100111001
100000001
111111111