NO ./textures/north.xpm
SO ./textures/south.xpm
WE ./textures/west.xpm
EA ./textures/east.xpm
F 100,100,100
C 200,200,200

1111111111
1000000001
1011111101
1000000001
1001N00001
1111111111
