NO ./textures/north.xpm
SO ./textures/south.xpm
WE ./textures/west.xpm
EA ./textures/east.xpm

C 35,19,73
F 15,6,40

1111111111111111111111111
1000000001111110000000001
1000000001000010000000001
1000000001000010000000001
1000000001000010000000001
1111000001000010000001111
1111000001000010000001111
1000000001000010000000001
1000000001000010000000001
1000000001000010000000001
100000000000N000000000001
1000000000000000000000001
1000000001000010000000001
1000000001000000000000001
1111000001000010000001111
1111000001000010000001111
1000000000000000000000001
1000000001000010000000001
1000000000000010000000001
1000000001111110000000001
1110011111111111111111111
1000000000000110000000001
1000000000000110000000001
1111111001111111111111111
111111100111111
111111000111111
111110000011111
111100000001111
111000000000111
110000000000011
100001111100001
110000111000011
111000010000111
111100000001111
111110000011111
111111000111111
111111111111111

